20
00022002222000000000
00003110002100000000
00002201100300000000
00010022222000000003
00000000002200000000
00000000003022000000
00001111002200000000
00000022030001000000
00001000222222000000
00000000000000222223
00000000111000000000
00000000100300000000
00002220000110000000
00000000011031100003
00000000030110000000
00000300000000000000
00000000022222200000
00000030000000300000
00000000000000000000
00000000000000000030