20
00000000000000000000
00000000000000000000
00000000000000000000
00000000002000000000
11111111120211111111
00330033020200330000
00003300020200000000
00002000020200333000
33000000332230200300
03300033002203300000
22222222222222222222
33333333333333333333
11111111111111111111
11111111111111111111
11111111111111111111
11111111111111111111
11111111111111111111
11111111111111111111
11111111111111111111
11111111111111111111